<!DOCTYPE html PUBLIC "-//W3C//DTD HTML 4.0 Transitional//EN" "http://www.w3.org/TR/REC-html40/loose.dtd">
<html><body><p>6IV Pokemon that I Need List

Ninjask - Jolly (Speed Boost)
Scolipede - Jolly (Speed Boost)
Weavile - Jolly (Pressure) (Icicle Crash)
Quagsire - Relaxed (Unaware)
Chansey - Bold (Natural Cure)
Garchomp - Impish &amp; Jolly (Rough Skin)
Hippowdon - Impish (Sand Stream)
Magnezone - Timid (Magnet Pull)
Medicham - Adamant (Pure Power)
Raikou - Timid
Entei - Adamant (Extremespeed if possible)
Suicune - Bold
Rotom - Calm
Tangrowth - Relaxed (Regenerator)
Tornadus - Timid
Thundurus - Timid
Aegislash - Modest &amp; Adamant
Genesect - Adamant (Extremespeed)
Ho-oh - Jolly (Regenerator)
Aggron - Impish (Sturdy)
Arcanine - Impish (Flash Fire)
Arcanine - Calm (Intimidate)
Chandelure - Modest (Flash Fire)
Chesnaught - Impish (Bulletproof)
Cloyster - Jolly (Skill LInk)
Cobalion - Jolly
Virizion - Jolly &amp; Timid
Conkeldurr - Adamant (Guts)
Crawdaunt - Adamant (Adaptability)
Cresselia - Bold or Calm
Crobat - Jolly (Infiltrator)
Empoleon - Bold (Defog) (Torrent)
Florges - Bold
Galvantula - Timid (Compound Eye)
Krookodile - Jolly (Moxie)
Heracross - Adamant (Moxie)
Machamp - Adamant (No Guard)
Mandibuzz - Careful (Overcoat)
Porygon2 - Calm (Trace)
Reuniclus - Calm (Magic Guard)
Roserade - Calm (Natural Cure)
Snorlax - Careful (Thick Fat)
Toxicroak - Adamant (Dry Skin)
Whimsicott - Bold (Prankster)
Dugtrio - Jolly (Arena Trap)
Durant - Jolly (Truant)
Durant - Jolly (Hustle)
Froslass - Timid (Cursed Body)
Honchkrow - Adamant (Moxie)
Houndoom - Timid (Flash Fire)
Kingdra - Timid &amp; Jolly (Swift Swim)
Yanmega - Timid (Speed Boost)
Zoroark - Timid
Banette - Adamant (Frisk) (Destiny Bond)
Ambipom - Jolly (Technician)
Accelgor - Timid (Unburden)
Cinccino - Jolly (Skill Link)
Cofarigus - Bold
Clawitzer - Modest
Druddigon - Impish (Rough Skin) (Glare)
Escavalier - Adamant (Overcoat)
Flygon - Jolly (Defog)
Jellicent - Calm (Water Absorb)
Scrafty - Adamant (Shed Skin) (Dragon Dance)
Sigilyph - Timid (Magic Guard (Psycho Shift &amp; Stored Power)
Azelf - Jolly
Uxie - Impish
Pyroar - Timid (Unnerve)
Vivillon - Timid (Compound Eyes)
Carracosta - Adamant or Jolly (Sturdy)
Floatzel - Jolly (Water Veil)</p></body></html>
